1111111111111
1C0100C00C0C1
1000011111001
1P0111E0C0001
1111111111111